▒▒▒▒▒▒▒▒▒▒▒▒▒▒▒▒▒▒▒▒▒▒▒▒▒▒▒▒
▒∙∙∙∙∙∙∙∙∙∙∙∙▒▒∙∙∙∙∙∙∙∙∙∙∙∙▒
▒∙▒▒▒▒∙▒▒▒▒▒∙▒▒∙▒▒▒▒▒∙▒▒▒▒∙▒
▒∙▒▒▒▒∙▒▒▒▒▒∙▒▒∙▒▒▒▒▒∙▒▒▒▒∙▒
▒∙▒▒▒▒∙▒▒▒▒▒∙▒▒∙▒▒▒▒▒∙▒▒▒▒∙▒
▒∙∙∙∙∙∙∙∙∙∙∙∙∙∙∙∙∙∙∙∙∙∙∙∙∙∙▒
▒∙▒▒▒▒∙▒▒∙▒▒▒▒▒▒▒▒∙▒▒∙▒▒▒▒∙▒
▒∙▒▒▒▒∙▒▒∙▒▒▒▒▒▒▒▒∙▒▒∙▒▒▒▒∙▒
▒∙∙∙∙∙∙▒▒∙∙∙▒▒▒▒∙∙∙▒▒∙∙∙∙∙∙▒
▒▒▒▒▒▒∙▒▒▒▒∙▒▒▒▒∙▒▒▒▒∙▒▒▒▒▒▒
▒    ▒∙▒▒▒▒∙∙∙∙∙∙▒▒▒▒∙▒    ▒
▒    ▒∙▒▒∙∙∙∙∙∙∙∙∙∙▒▒∙▒    ▒
▒    ▒∙▒▒∙▒▒▒▒▒▒▒▒∙▒▒∙▒    ▒
▒▒▒▒▒▒∙▒▒∙▒      ▒∙▒▒∙▒▒▒▒▒▒
∙∙∙∙∙∙∙∙∙∙▒      ▒∙∙∙∙∙∙∙∙∙∙
▒▒▒▒▒▒∙▒▒∙▒      ▒∙▒▒∙▒▒▒▒▒▒
▒    ▒∙▒▒∙▒▒▒▒▒▒▒▒∙▒▒∙▒    ▒
▒    ▒∙▒▒∙∙∙∙∙∙∙∙∙∙▒▒∙▒    ▒
▒    ▒∙▒▒∙▒▒▒▒▒▒▒▒∙▒▒∙▒    ▒
▒▒▒▒▒▒∙▒▒∙▒▒▒▒▒▒▒▒ ▒▒ ▒▒▒▒▒▒
▒∙∙∙∙∙∙∙∙∙∙∙∙▒▒∙∙∙∙∙∙∙∙∙∙∙∙▒
▒∙▒▒▒▒∙▒▒▒▒▒∙▒▒∙▒▒▒▒▒∙▒▒▒▒∙▒
▒∙▒▒▒▒∙▒▒▒▒▒∙▒▒∙▒▒▒▒▒∙▒▒▒▒∙▒
▒∙∙∙▒▒∙∙∙∙∙∙∙∙∙∙∙∙∙∙∙∙▒▒∙∙∙▒
▒▒▒∙▒▒∙▒▒∙▒▒▒▒▒▒▒▒∙▒▒∙▒▒∙▒▒▒
▒▒▒∙▒▒∙▒▒∙▒▒▒▒▒▒▒▒∙▒▒∙▒▒∙▒▒▒
▒∙∙∙∙∙∙▒▒∙∙∙∙▒▒∙∙∙∙▒▒∙∙∙∙∙∙▒
▒∙▒▒▒▒▒▒▒▒▒▒∙▒▒∙▒▒▒▒▒▒▒▒▒▒∙▒
▒∙▒▒▒▒▒▒▒▒▒▒∙▒▒∙▒▒▒▒▒▒▒▒▒▒∙▒
▒∙∙∙∙∙∙∙∙∙∙∙∙∙∙∙∙∙∙∙∙∙∙∙∙∙∙▒
▒▒▒▒▒▒▒▒▒▒▒▒▒▒▒▒▒▒▒▒▒▒▒▒▒▒▒▒